
EA                      ./images/est.xpm
SO                ./images/no.xpm       


WE ./images/so.xpm

NO ./images/we.xpm 

C 12,  225   ,    181           
F           161    ,161,      164       





            1111111111111111111111111111111111111111111111111111
            10000000001100000000111110000000001111  11111    11111
    111111111000001000000000000111000000111111111111    111111
    1000000000110010000000010000000000011111  10001
    111111111111100000N0100010000000000001111111111111
    10000000001100000000000010000000000000011 1111 111111
    10110000011100000000000000000000000001111111111111111
    10000000001100000000010000000000000011111111111111111
1111111111111111111111111111111111111111111111111111111111
1
1
1
1111111111111111111111111111111111111111111111111111111111
    10110000011100000000000000000000000011111111111111111
    10000000001100000000000000000000000001 11111111111111
    1011000001110000000000000000000000011111111101111111
    10010000000000000000000000000000000001111111111111111
    100000111000000000000101100000000000011111111111111
    1111111111111111111011111111111111111111111111111111
1111111111111111111111111111111111111111111111111111111111
