NO 3textures/wood_strips.xpm
SO 2textures/wood.xpm
WE 1textures/wood_box.xpm
EA 33textures/rocks.xpm

C 103, 12, 900
F 12, 122, 90
        111111111111111111111111111111111111111111111
       100000000000000000000000000000S00000000000000011
      111111111111111111111111111111111111111