NO 3textures/wood_strips.xpm
SO 2textures/wood.xpm
WE 1textures/wood_box.xpm
EA 33textures/rocks.xpm

C 103, 12, 900
F 12, 122, 92

111111111111111111111111111111111
111111111011000001110000000000001
100000000011111111111111111111111
1111111111
1        1
1        1
1111111111111111111111111111111
11000001110101011111011110N011111