EA sjsjs.xpm
SO BBB.xpm
NO III.xpm
WE QQQ.xpm

11111000000011111
00000010111100000]
abbbcddddddef
12334