NO 3textures/wood_strips.xpm
SO 2textures/wood.xpm
WE 1textures/wood_box.xpm
EA 33textures/rocks.xpm

C 103, 193, 202
F 125, 130, 140

                                                       111111111111111111111111111111111111111111111
                                                       100000000000000000000000000000000000000000000011
      111111111111111111111111111111111111111