

EA         sjsjs.xpm
      
      
      
      
            SO BBB.xpm
NO III.xpm
        WE QQQ.xpm

F             90, 91,     90         
               C 97, 85,               127











111111111111111111
100000101111000001
1bbbcdddddde1
111111